#######
#D#   #
# ### #
#  #S #
#F#F# #
#     #
#######
