#####
#D F#
# ## #
#  S#
#####
